02000000000000000000
01000000000000000000
01000000000000000000
01000000000000000000
01000000000000000000
01000000000000000000
01000000000000000000
01000000000000000000
01000000000000000000
01000000000000000000
01000000000000000000
03000000000000000000