00300000000000000000
00100000001111110000
00100000001000010000
00100000001000011112
00100000001000000000
00100000001000000000
00100000001000000000
00100000001000000000
00100000001000000000
00111111111000000000
00000000000000000000
00000000000000000000

