00000000002000000000
00000000001000000000
00000000001000000000
00000000001000000000
00000000001000000000
00000000001000000000
00000000001000000000
00000000001000000000
00000000001000000000
00000000001000000000
00000000001000000000
00000000003000000000