00020000000000000030
00010000000000000010
00010000000000000010
00011000000000000010
00001100000000000110
00000110000000001100
00000011000000011000
00000001100000110000
00000000110001100000
00000000011011000000
00000000001110000000
00000000000000000000