00000000000000002000
00000000000000001000
00000000000000001000
00000000000000001000
00000000000000001000
00000000000000001000
00000000000000001000
00000000000000001000
00000000000000001000
00000000000000001113
00000000000000000000
00000000000000000000