00000000000000002000
00000000000000001000
00111111111111111000
00100000000000000000
00111111111111111000
00000000000000001000
00000011111111111000
00000010000000000000
00000011111111111000
00000000000000001113
00000000000000000000
00000000000000000000