00000000000000002000
00000000000000001000
00000000000000001000
00000000000000001000
00000000000000001000
00000000o00000001000
00000000000000001000
00000000000000001000
00000000000000001000
00000000000000001113
000a0000000000000000
00000000000000000000
