00000000000000002000
00000000000000001000
00000000000000001000
00000000000000001000
00001111111111111000
00001000000010000000
00001000000010000000
00001111111111111110
00000000000000000010
00000000000000000010
00001111111111111110
00003000000000000000