00000000000000002000
00000000000000001000
00000000000000001000
00000000000000001000
00000000000000001000
00000000000000001000
00000000000000001000
00000000000000001000
00000000000000001000
00000000000000001000
00000000000000001000
00000000000000003000