00000000000000000000
21111111111111111000
00000000000000001000
00000000000000001000
00001111111111111000
00001000000000000000
00001000000000000000
00001111111111111110
00000000000000000010
00000000000000000010
00001111111111111110
00001000000000000000
00003000000000000000